



[=====]                 W   
                      |     |             [===]   
                      |  B  |             |       
          P       [===]     [===]         |       
      [=====]     |           |           |       
      |     |     |           |       []  |       
      |     |     |    MMM    |       ||  |       
      |     |     |           |       ||  |       
      |     [=====]           [=======..==]       
      |                              ..           
[=====]                              ..