.....||||||||||||||||.............................
.....                    ..........................
.....                      |||||........|||||||||| 
..... P    H               H      ||...||||||      
|||||||||||H|||||          H       ||   H          
           H               H       H    H          
           H               H       H    H     [==] 
           H               H       H    H          
           H               H       H    H          
           H     ]         H       H    H          
[================|         []      H    H    W     
|||||||||||||||||.   []            H         [==]  
..................                                 
..................                                 
..................MMMMMMMMMMMMMMMMMMMMMMMMMMMMMMMM 